jeden : один  
dwa : два  
trzy : три  
cztery : четыре  
pięć : пять  
sześć : шесть  
siedem : семь  
osiem : восемь  
dziewięć : девять  
dziesięć : десять  
jedenaście : одиннадцать  
dwanaście : двенадцать  
trzynaście : тринадцать  
czternaście : четырнадцать  
piętnaście : пятнадцать  
szesnaście : шестнадцать  
siedemnaście : семнадцать  
osiemnaście : восемнадцать  
dziewiętnaście : девятнадцать  
dwadzieścia : двадцать  
trzydzieści : тридцать  
czterdzieści : сорок  
pięćdziesiąt : пятьдесят  
sześćdziesiąt : шестьдесят  
siedemdziesiąt : семьдесят  
osiemdziesiąt : восемьдесят  
dziewięćdziesiąt : девяносто  
sto : сто  
dwieście : двести  
trzysta : триста  
czterysta : четыреста  
pięćset : пятьсот  
sześćset : шестьсот  
siedemset : семьсот  
osiemset : восемьсот  
dziewięćset : девятьсот  
oba : оба  
obydwa : оба  
dwoje : двое  
oboje : обоих  
troje : трое  
czworo : четверо  
pół : пол  
półtora : полтора  
kilka : несколько  
kilkanaście : несколько
kilkadziesiąt : несколько десятков  
kilkaset : несколько сотен  
parę : пару  
ile : сколько  
ileż : сколь же  
tyle : столько  
wiele : много  
niewiele : немного  

co : что  
cokolwiek : что угодно  
coś : что-то  
cóż : что же  
ja : я  
jedno : одно  
kto : кто  
ktokolwiek : кто угодно  
ktoś : кто-то  
któż : кто же  
nic : ничего  
nikt : никто  
my : мы  
on : он  
samo : само  
siebie : себя  
się : себя 
tamto : то самое 
to : это  
ty : ты  
wszystko : всё  
wy : вы  

bez : без  
blisko : близко  
celem : с целью  
co : что  
dla : для  
do : до, к  
dokoła : вокруг  
dookoła : вокруг  
drogą : через  
dzięki : благодаря  
jako : как  
koło : около  
ku : к  
między : между  
mimo : несмотря на  
na : на  
nad : над  
naprzeciw : напротив  
naprzeciwko : напротив  
niby : как будто  
niczym : ничем  
niedaleko : недалеко  
o : об  
obok : возле  
od : от  
odnośnie : относительно  
około : около  
oprócz : кроме  
po : после  
pod : под  
podczas : во время  
pomiędzy : между  
pomimo : несмотря на  
ponad : более, над  
poniżej : ниже  
poprzez : через  
pośrodku : посередине  
pośród : среди  
powyżej : выше  
poza : за пределами  
prócz : кроме  
przeciw : против  
przeciwko : против  
przed : перед  
przez : через  
przy : при, около  
spod : из-под  
spośród : среди  
spoza : извне  
sprzed : из-под 
temu : тому 
u : у  
w : в  
wbrew : вопреки  
wedle : согласно  
według : согласно
wewnątrz : внутри  
wobec : по отношению к  
wokół : вокруг  
wskutek : вследствие  
wśród : среди  
wzdłuż : вдоль  
względem : относительно  
z : из  
za : за 
zamiast : вместо  
znad : над чем-то
zza : из-за  

a : а  
aby : чтобы  
aczkolwiek : хотя  
albo : или  
albowiem : ибо  
ale : но  
ależ : однако же  
ani : ни  
aniżeli : нежели  
aż : до, вплоть до  
ażeby : чтобы  
bądź : либо  
bo : потому что  
bowiem : ведь  
by : чтобы  
byle : лишь бы  
chociaż : хотя  
chociażby : хотя бы  
choć : хоть  
choćby : хоть бы  
co : что  
dopóki : пока  
gdy : когда  
gdyby : если бы  
gdyż : так как  
i : и  
ile : сколько  
im : чем  
iż : что  
jak : как  
jakkolwiek : как бы ни  
jako : как  
jako że : так как  
jednakże : однако  
jeśli : если  
jeśliby : если бы  
lecz : но  
lub : или  
mimo iż : несмотря на то что  
natomiast : зато
ni : ни  
nie tyle : не столько  
nim : прежде чем  
niż : чем  
o ile : если, насколько  
o tyle : настолько  
oraz : а также  
podczas gdy : в то время как  
ponieważ : поскольку  
póki : пока  
przeto : поэтому  
skoro : поскольку  
tedy : значит  
to : то  
toteż : поэтому  
tyle że : только что  
tym : тем  
więc : следовательно  
zamiast : вместо  
zanim : прежде чем  
zarówno : как ... так и  
zaś : же  
zatem : следовательно  
że : что  
żeby : чтобы  

aby : чтобы  
ale : но  
akurat : как раз  
ano : ну да  
bądź : либо  
bądź co bądź : как бы то ни было  
bodaj : хотя бы  
by : чтобы  
bynajmniej : вовсе нет  
chyba : наверное
co : что  
co najmniej : по крайней мере  
co najwyżej : самое большее  
co prawda : правда   
coś : что-то  
cóż : что же  
czego : чего  
czemu : почему  
czy : ли  
czyli : то есть  
czyż : разве  
czyżby : неужели  
dlaczego : почему  
dlatego : поэтому  
dopiero : только  
doprawdy : в самом деле  
ino : только, лишь  
jak : как  
jak gdyby : как будто  
jakby : как бы  
jakoby : будто бы  
jakoś : как-то  
jakże : как же  
jednak : однако  
jedynie : лишь  
jeno : только  
jeszcze : ещё  
lada : любой 
ledwie : едва  
ledwo : едва  
mianowicie : а именно  
między innymi : среди прочего  
mniejsza : неважно  
może : может быть  
możliwie : возможно  
nader : крайне  
nadto : сверх того  
naprawdę : действительно  
nareszcie : наконец-то  
następnie : затем  
naturalnie : естественно  
nawet : даже  
nie : не  
niech : пусть  
niechaj : пусть  
niechże : пусть же  
niejako : в некотором роде  
niemal : почти  
niemniej : тем не менее  
nieomal : почти  
niestety : к сожалению  
niewątpliwie : несомненно  
no : ну  
oczywiście : конечно  
omal : чуть не  
oto : вот  
otóż : итак  

bać się : бояться  
biegać : бегать  
boleć : болеть  
brać : брать  
być : быть  
całować : целовать  
chcieć : хотеть  
chodzić : ходить  
chronić : защищать, охранять  
cieszyć się : радоваться  
ćwiczyć : тренироваться  
czekać : ждать  
czuć : чувствовать  
czytać : читать  
dać : дать  
dokonać : доработать  
dostać : получить  
dotrzeć : добраться  
dowiedzieć się : узнать  
drażnić : раздражать  
działać : действовать  
dziękować : благодарить  
dzwonić : звонить  
farbować : красить  
gotować : готовить  
grać : играть  
interesować się : интересоваться  
irytować : раздражать  
jechać : ехать  
jeść : есть  
jeździć : ездить  
kierować : управлять  
kochać : любить  
kończyć : закончить  
korzystać : пользоваться  
kosztować : стоить  
kroić : резать  
kupić : купить  
kupować : покупать  
łapać : ловить  
leżeć : лежать  
liczyć : считать, рассчитывать  
lubić : любить  
malować : рисовать  
martwić się : волноваться  
marzyć : мечтать  
mieć : иметь  
mieszkać : жить  
móc : мочь  
mówić : говорить  
musieć : быть вынужденным  
myśleć : думать  
napisać : написать  
nauczyć : научить  
nazywać się : называться  
nieść : нести  
nosić : носить  
nudzić się : скучать  
oddać : отдать  
oddzwonić : перезвонить  
odebrać : забрать  
odejść : отойти  
odnaleźć : найти  
odpoczywać : отдыхать  
odpowiedzieć : ответить  
okazać : предоставить  
opowiedzieć : рассказать  
organizować : организовать  
otworzyć : открыть  
ożenić się : жениться  
palić : курить  
pamiętać : помнить  
patrzeć : смотреть  
pić : пить  
pisać : писать  
płacić : платить  
planować : планировать  
pływać : плавать  
pobrać się : жениться  
podnieść : преподнести  
podobać się : нравиться  
podróżować : путешествовать  
pójść : пойти  
pokazać : показать  
polecać : рекомендовать  
położyć : положить  
pomóc : помочь  
pomyśleć : подумать  
poprosić : попросить  
potrzebować : потребовать  
powiedzieć : сказать  
powstrzymać : придержать  
powtarzać : повторять  
powtórzyć : повторить  
poznać : познать, узнать  
pozostać : остаться  
pozwolić : позволить  
pracować : работать  
proponować : предлагать  
prosić : просить  
przeczytać : прочитать  
przedstawić się : представиться  
przejść : прийти  
przekonać : убедить  
przepraszać : извиняться  
przyjąć : принять  
przyjmować : принимать  
przyjść : прийти  
przymierzyć : примерить  
przypomnieć : вспомнить  
pytać : спрашивать  
rezerwować : резервировать  
robić : делать  
rozbić : разбить  
rozmawiać : разговаривать  
rozumieć : понимать  
rzucić : бросить  
segregować : сортировать  
siedzieć : сидеть  
skończyć : закончить  
słuchać : слушать  
słychać : слышать, слышно  
słyszeć : слышать  
spać : спать  
śpiewać : петь  
spodziewać się : ожидать, надеяться  
spojrzeć : посмотреть  
spotkać : встретить  
spotykać się : встретиться  
spóźnić się : опоздать  
sprawdzić : проверить  
spróbować : попробовать  
sprzątać : убирать  
sprzedawać : продавать  
stać : стать  
stosować : применять  
studiować : учиться  
szukać : искать  
tańczyć : танцевать  
telefonować : звонить  
tłumaczyć : переводить  
tyć : толстеть  
uciekać : убегать  
uczyć się : учиться  
uczynić : сделать  
uderzyć się : удариться  
ukraść : украсть  
ukryć : скрыть  
umawiać się : договариваться  
umrzeć : умереть  
upaść : упасть  
urodzić się : родиться  
usłyszeć : услышать  
uśmiechać się : улыбаться  
uwierzyć : поверить  
używać : принимать  
walczyć : драться  
wejść : войти  
widać : видно, можно увидеть  
widzieć : видеть  
wiedzieć : знать  
wierzyć : верить  
wisieć : висеть  
woleć : хотеть, желать  
wracać : возвращаться  
wrócić : вернуться  
wyglądać : выглядеть  
wyjść : выйти  
wynająć : снять  
wyobrazić : представить  
wysłać : послать  
wziąć : взять  
zachować : сохранить, задержать  
zacząć : начать  
zależeć : зависеть  
zapomnieć : забыть  
zapraszać : приглашать  
zapytać : спросить  
zarabiać : зарабатывать  
zarejestrować : зарегистрировать  
żartować : шутить  
zaspać : проспать  
zastanawiać się : размышлять  
zatrzymać : задержать  
zbudować : построить  
zdążyć : успеть  
zdecydować : решить  
zdobyć : получить  
zepsuć się : испортиться  
zgubić : потерять  
złamać : сломать  
zmienić : изменить  
znać : знать  
znaleźć : найти  
zobaczyć : увидеть  
zostać : остаться  
zostawić : оставить  
zrobić : сделать  
zrozumieć : понять  
życzyć : желать  
